#	f	c	#	c	#	#	c	#	c	#
c	#	#	c	c	#	#	c	#	#	#
c	#	#	#	#	c	c	#	#	#	c
c	e	#	#	#	#	c	#	#	c	#
#	c	#	c	c	#	#	#	c	c	#
#	#	c	#	e	#	#	#	c	f	#
c	#	#	#	#	#	#	#	#	#	#
#	f	#	c	#	#	c	#	c	c	#
#	c	#	c	c	c	#	#	c	#	#
#	c	#	c	#	c	#	e	c	c	#
#	#	c	c	#	p	c	#	c	#	#